---------------------------------------------------------------------------------------------------------------------------------------------------------------
-------------------------------------------------------------------------CCCC----------------------------------------------------------------------------------
-----------------------------------------------------------------------########----------------------------------------------CC--------------------------------
--------------------------------CC----------------------------------#-----------------------------------------------------#---CC-------------------------------
-------------------------------CCCC--------------------------CC----------------C--C--------------------------------------##----CC------------------------------
------------##--------------------------------------------#----G-#------------CCCCCC-----------------########-----------###-----CC-----------------------------
-----##---------------#-##-#--##--##-#-#--###-------------########-------#-----C--C----------------##------------------####------CC----------------------------
-----##---C---C---#-G-----G#------------------#----G--#------------#--------------------#--#-----#-CCCCCCCCCG----#----#####-------CC----------F----------------
#######-###-####--##########------------------########################################--------#############################----##############################--
