---------------------------------------------------------------------
-------------------------------CCC-----------------------------------
------------##-------------#-----------------------------------#----#
-----#----------------#-##----##--##-#-#--###-------------###-------#
----#------C---C----#-G----G#------------------#----G--#------------#
#########-###-####--#########------------------######################
