-----------------------------------------------------------
-----------------------------------------------------------
--##-------------#-----------------------------------#----#
-----#------#-##----##--##-#-#--###-------------###-------#
----#---#-#-G----G#------------------#-------#------------#
##-######-#########------------------######################
