-----------------------------------------------------------
-----------------------------------------------------------
--##-------------#-----------------------------------#----#
-----#-----##-##----##--##-#-#--###-------------###-------#
----#---#----------------------------#-------#------------#
##-######-#########------------------######################
