-----------------------------------------------------------
---------------------CCC-----------------------------------
--##-------------#-----------------------------------#----#
-----#------#-##----##--##-#-#--###-------------###-------#
----#---#-#-G----G#------------------#-------#------------#
##-######-#########------------------######################
