----------------------------------------------------------------------------------------------
----------------------------------------------------------------------------------------------
-------------------------------CCC------------------------------------------------------------
------------##-------------#-----------------------------------#----#-------------------------
-----#----------------#-##----##--##-#-#--###-------------###-------#-------------------------
----#---#--C---C----#-G----G#------------------#----G--#----------F-#-------------------------
#########-###-####--#########------------------######################-------------------------
