-----------------------------------------------------------
---------------------CCC-----------------------------------
--##-------------#-----------------------------------#----#
-----#------#-##----##--##-#-#--###-------------###-------#
----#---#-#-G----G#------------------#----G--#------------#
##-######-#########------------------######################
