-----------------------------------------------------------
-----------------------------------------------------------
--##-------------#-----------------------------------#----#
-----#------#-##----##--##-#-#--###-------------###-------#
----#---#-#-------#------------------#-------#------------#
##-######-#########------------------######################
